147,147,147,147,147,147,147,147,147,147,147,147,147,147,144,145,146,145,146,144,145,146,144,145,144,145,146,147,147,147,147,147,147,147,147,147,147,147,147,147
147,147,147,147,147,147,147,147,147,147,147,147,147,147,150,151,152,151,152,150,164,152,150,151,150,151,152,147,147,147,147,147,147,147,147,147,147,147,147,147
147,147,147,147,147,147,147,147,147,147,147,147,147,147,176,165,166,166,166,166,166,166,166,166,166,167,174,147,147,147,147,147,147,147,147,147,147,147,147,147
147,147,147,147,147,147,147,147,147,147,147,147,147,147,174,171,172,172,172,172,172,172,172,172,172,173,175,147,147,147,147,147,147,147,147,147,147,147,147,147
147,147,147,147,147,147,147,147,147,147,147,147,147,147,175,171,172,168,168,168,168,172,172,172,172,173,176,147,147,147,147,147,147,147,147,147,147,147,147,147
147,147,147,147,147,147,147,147,147,147,147,147,147,147,176,171,168,168,168,168,168,168,168,172,168,173,174,147,147,147,147,147,147,147,147,147,147,147,147,147
147,147,147,147,147,147,147,147,147,147,147,147,147,147,174,177,178,178,178,178,178,178,178,178,178,179,175,147,147,147,147,147,147,147,147,147,147,147,147,147
147,147,147,147,147,147,147,147,147,147,147,147,147,147,147,147,147,147,147,174,175,176,147,147,147,147,147,147,147,147,147,147,147,147,147,147,147,147,147,147
147,147,147,147,147,147,147,147,147,147,147,147,147,147,147,147,147,147,147,175,176,174,147,147,147,147,147,147,147,147,147,147,147,147,147,147,147,147,147,147
147,147,147,147,147,147,147,147,147,147,147,147,147,147,147,147,146,144,145,176,174,175,146,144,145,147,147,147,147,147,147,147,147,147,147,147,147,147,147,147
147,147,147,147,147,147,147,147,147,147,147,147,147,147,147,147,152,150,151,174,175,176,152,150,151,147,147,147,147,147,147,147,147,147,147,147,147,147,147,147
147,147,147,147,147,147,147,147,147,147,147,147,147,147,147,147,176,174,175,176,174,175,176,174,175,147,147,147,147,147,147,147,147,147,147,147,147,147,147,147
147,147,147,147,147,147,147,147,147,147,147,147,147,147,147,147,175,165,166,166,166,166,166,167,174,147,147,147,147,147,147,147,147,147,147,147,147,147,147,147
147,147,147,147,147,147,147,147,147,147,147,147,147,147,147,147,174,171,172,168,168,168,172,173,175,147,147,147,147,147,147,147,147,147,147,147,147,147,147,147
147,147,147,147,147,147,147,147,147,147,147,147,147,147,147,147,176,177,178,178,178,178,178,179,174,147,147,147,147,147,147,147,147,147,147,147,147,147,147,147
147,147,147,147,147,147,147,147,147,147,147,147,147,147,147,147,174,175,176,174,175,176,174,175,176,147,147,147,147,147,147,147,147,147,147,147,147,147,147,147
147,147,147,147,147,147,147,147,147,147,147,147,147,147,147,147,147,147,147,175,176,174,147,147,147,147,147,147,147,147,147,147,147,147,147,147,147,147,147,147
147,147,147,147,147,147,147,147,147,147,147,147,147,147,147,147,147,147,147,166,166,166,147,147,147,147,147,147,147,147,147,147,147,147,147,147,147,147,147,147
147,147,147,147,147,147,147,147,147,147,147,147,147,147,147,147,147,147,147,178,178,178,147,147,147,147,147,147,147,147,147,147,147,147,147,147,147,147,147,147
147,147,147,147,147,147,147,147,147,147,147,147,147,147,147,147,147,147,149,174,175,176,147,147,147,147,147,147,147,147,147,147,147,147,147,147,147,147,147,147
147,147,147,147,147,147,147,147,147,147,147,147,147,147,147,147,147,147,149,165,166,167,148,147,147,147,147,147,147,147,147,147,147,147,147,147,147,147,147,147
147,147,147,147,147,147,147,147,147,147,147,147,147,147,147,147,147,144,145,171,172,173,146,144,147,147,147,147,147,147,147,147,147,147,147,147,147,147,147,147
147,147,147,147,147,147,147,147,147,147,147,147,147,147,147,147,147,150,151,177,178,179,152,150,147,147,147,147,147,147,147,147,147,147,147,147,147,147,147,147
147,147,147,147,147,147,147,147,147,147,147,147,147,147,147,147,147,174,175,176,174,175,176,174,147,147,147,147,147,147,147,147,147,147,147,147,147,147,147,147
147,147,147,147,147,147,147,147,147,147,147,147,147,147,147,147,147,165,166,166,166,166,166,167,147,147,147,147,147,147,147,147,147,147,147,147,147,147,147,147
147,147,147,147,147,147,147,147,147,147,147,147,147,147,147,147,147,171,168,172,168,172,172,173,147,147,147,147,147,147,147,147,147,147,147,147,147,147,147,147
147,147,147,147,147,147,147,147,147,147,147,147,147,147,147,147,147,171,172,172,172,172,172,173,147,147,147,147,147,147,147,147,147,147,147,147,147,147,147,147
147,147,147,147,147,147,147,147,147,147,147,147,147,147,147,147,147,177,178,178,178,178,178,179,147,147,147,147,147,147,147,147,147,147,147,147,147,147,147,147
147,147,147,147,147,147,147,147,147,147,147,147,147,147,147,147,147,147,147,174,175,176,147,147,147,147,147,147,147,147,147,147,147,147,147,147,147,147,147,147
147,147,147,147,147,147,147,147,147,147,147,147,147,147,147,147,147,147,147,175,176,174,147,147,147,147,147,147,147,147,147,147,147,147,147,147,147,147,147,147
147,147,147,147,147,147,147,147,147,147,147,147,147,147,147,147,147,147,147,176,174,175,147,147,147,147,147,147,147,147,147,147,147,147,147,147,147,147,147,147
147,147,147,147,147,147,147,147,147,147,147,147,146,144,145,146,144,145,146,174,175,176,144,145,146,144,145,146,144,147,147,147,144,145,146,147,147,147,147,147
147,147,147,147,147,147,147,147,147,147,147,147,152,150,151,152,150,151,152,175,176,174,150,151,152,150,151,152,150,144,145,146,150,151,152,147,147,147,147,147
147,147,147,147,147,147,147,147,147,147,147,147,176,174,175,176,174,175,176,176,174,175,176,174,175,176,174,175,176,150,151,152,165,166,167,147,147,147,147,147
147,147,147,147,147,147,147,147,147,147,147,147,174,165,166,166,166,166,166,166,166,166,166,166,166,166,166,167,174,174,175,176,171,172,173,147,147,147,147,147
147,147,147,147,147,147,147,147,147,147,147,147,175,171,172,172,172,172,172,172,172,172,172,172,172,172,172,173,175,147,147,147,177,178,179,147,147,147,147,147
147,147,147,147,147,147,147,147,147,147,147,147,176,171,172,172,172,172,172,172,172,168,172,172,172,172,172,173,176,147,147,147,147,147,147,147,147,147,147,147
147,147,147,147,147,147,147,147,147,147,147,147,175,171,172,172,172,172,172,172,172,172,172,172,172,172,172,173,174,147,147,147,147,147,147,147,147,147,147,147
147,147,147,147,147,147,147,147,147,147,147,147,175,171,172,172,172,172,172,172,172,172,172,172,172,172,172,173,175,147,147,147,147,147,147,147,147,147,147,147
147,147,147,147,147,147,147,147,147,147,147,147,176,177,178,178,178,178,178,178,178,178,178,178,178,178,178,179,176,147,147,147,147,147,147,147,147,147,147,147
147,147,147,147,147,147,147,147,147,147,147,147,174,175,176,174,175,176,174,175,176,174,175,176,174,175,176,174,175,147,147,147,147,147,147,147,147,147,147,147
147,147,147,147,147,147,147,147,147,147,147,147,147,147,147,147,147,147,147,147,147,147,147,147,147,147,147,147,147,147,147,147,147,147,147,147,147,147,147,147
147,147,147,147,147,147,147,147,147,147,147,147,147,147,147,147,147,147,147,147,147,147,147,147,147,147,147,147,147,147,147,147,147,147,147,147,147,147,147,147
147,147,147,147,147,147,147,147,147,147,147,147,147,147,147,147,147,147,147,147,147,147,147,147,147,147,147,147,147,147,147,147,147,147,147,147,147,147,147,147
147,147,147,147,147,147,147,147,147,147,147,147,147,147,147,147,147,147,147,147,147,147,147,147,147,147,147,147,147,147,147,147,147,147,147,147,147,147,147,147
147,147,147,147,147,147,147,147,147,147,147,147,147,147,147,147,147,147,147,147,147,147,147,147,147,147,147,147,147,147,147,147,147,147,147,147,147,147,147,147
147,147,147,147,147,147,147,147,147,147,147,147,147,147,147,147,147,147,147,147,147,147,147,147,147,147,147,147,147,147,147,147,147,147,147,147,147,147,147,147
